11
60
############################################################
#                     #          #      #                  #
#                     #          #      #                  #
#                     #B               B#                 B#
#         b W b       #      b W b                         #
#          ---                ---                          #
#                                              b W b       #
#    ---                          ---           ---        #
#Pb       W       b       b    W              b       G    #
^^^^^^^^^^^^^^^^^^    c    ^^^^^^^^^^^^^^^^^^^        ^  ^^^
                  ____^____                   ___________   