########################################
#                                      #
#                                      #
#                                      #
#                                      #
#             ttt                      #
#        ttt                           #
#    ttt                               #
#P                                 G   #
^^^^^^^^^^^^^^^^^^^^^    ^^^^^^^^^^^^^^^
                     ____               